11111111111111111111111
110P0C001E1000000011001
10000000101000C00010001
11100C00101C00100010001
11100000000000000010001
1000000C000111110000011
100010C0000011100000011
10001000000001000000011
11111111111111111111111
