111111111111111111111111
110000001E10000000110011
100000001010000000100011
111000001010001000100011
111000000C00000000100011
100000000C01111100000111
100010000C00111000000111
10001000P000010000000111
111111111111111111111111