111111111111111111111111
110000001E10000000110011
100000001010000000100011
111000001010001000100011
1111000000C0000000010001
100000000C01111100000111
1000100000C0011100000011
10001000P00C010000000111
111111111111111111111111